█████████████████████████████████████████
█    █              █                   █
█    █              █                   █
█    █              █                   █
█                   █                   █
██████   █  █████  █████   █            █
█        █                 █            █
█        █                 █            █
█        █                 █            █
█████████████████████████████████████████